=== AREA: sanctum ===
name: Crumbling Sanctum
flavor: Ancient machinery hums within these forgotten halls.
size: 50x50
background: #383861
ground: #3a3a3a
ambient: 0.45
directional: 0.4
fog: true
spawn: 3,25

=== GEOMETRY ===
##################################################
##################################################
##################################################
##################################################
##################################################
##################################################
##################################################
##################################################
##################................................
##################................................
##################................................
##################................................
##################................................
##################................................
##################................................
##################................................
##################................................
##################................................
##################................................
##################................................
<.................................................
<.................................................
<.................................................
<.................................................
<.................................................
<.................................................
<.................................................
<.................................................
<.................................................
<.................................................
##################................................
##################................................
##################................................
##################................................
##################................................
##################................................
##################................................
##################................................
##################................................
##################................................
##################................................
##################................................
##################################################
##################################################
##################################################
##################################################
##################################################
##################################################
##################################################
##################################################

=== TERRAIN ===
..................................................
..................................................
..................................................
..................................................
..................................................
..................................................
..................................................
..................................................
..................................................
..................................................
..................................................
..................................................
..................................................
..................................................
..................................................
..................................................
..................................................
..................................................
..................................................
..................................................
..................................................
..................................................
..................................................
..................................................
..................................................
..................................................
..................................................
..................................................
..................................................
..................................................
..................................................
..................................................
..................................................
..................................................
..................................................
..................................................
..................................................
..................................................
..................................................
..................................................
..................................................
..................................................
..................................................
..................................................
..................................................
..................................................
..................................................
..................................................
..................................................
..................................................

=== FLOOR ===
..................................................
..................................................
..................................................
..................................................
..................................................
..................................................
..................................................
..................................................
..................................................
..................................................
..................................................
..................................................
..................................................
..................................................
..................................................
..................................................
..................................................
..................................................
..................................................
..................................................
..................................................
..................................................
..................................................
..................................................
..................................................
..................................................
..................................................
..................................................
..................................................
..................................................
..................................................
..................................................
..................................................
..................................................
..................................................
..................................................
..................................................
..................................................
..................................................
..................................................
..................................................
..................................................
..................................................
..................................................
..................................................
..................................................
..................................................
..................................................
..................................................
..................................................

=== ENEMIES ===
33.5,25.5:ancient_construct

=== CHESTS ===
40.5,25.5:gold=20

=== TRANSITIONS ===
0,23,1,4:west->ruins@43,25

=== DECORATIONS ===
21,9:small_rock
24,9:small_rock
46,9:small_rock
20,10:broken_wall,rot=1.571,size=1
48,10:small_rock
20,11:small_rock
22,12:broken_column,size=0.9
42,14:broken_column,size=1
43,14:small_rock
33,17:column,size=1.3
33,18:small_rock
27,19:column,size=1.3
39,19:column,size=1.3
4,21:column,size=1
10,21:column,size=1
16,21:column,size=1
24,25:small_rock
25,25:column,size=1.3
41,25:column,size=1.3
44,25:broken_wall,rot=0.000,size=0.9
4,28:column,size=1
10,28:column,size=1
16,28:column,size=1
27,31:column,size=1.3
39,31:column,size=1.3
40,32:small_rock
33,33:column,size=1.3
20,36:broken_column,size=0.8
44,38:broken_column,size=1.1
19,39:small_rock
18,40:rock
24,40:small_rock
30,40:broken_wall,rot=1.571,size=1
20,41:broken_wall
23,41:rock
47,41:rock

=== LIGHTS ===
10.5,25.5:radius=18,angle=65,tint=#eb8aff,brightness=20,height=10,diffusion=0.55,decay=1
20.5,25.5:radius=18,angle=65,tint=#eb8aff,brightness=20,height=10,diffusion=0.55,decay=1
31.5,25.5:radius=18,angle=65,tint=#eb8aff,brightness=20,height=10,diffusion=0.55,decay=1
38.5,35.5:radius=18,angle=65,tint=#eb8aff,brightness=20,height=10,diffusion=0.55,decay=1
39.5,15.5:radius=18,angle=65,tint=#eb8aff,brightness=20,height=10,diffusion=0.55,decay=1
